300 300 300 300 300 300 300 300 300 300 300 300 300 300 300 300 300
300 000 000 000 120 300 300 300 300 300 300 300 300 300 300 300 300
300 000 000 000 120 300 300 300 300 300 300 300 300 300 300 300 300
300 000 000 000 120 300 300 300 300 300 300 300 300 300 300 300 300
300 120 120 120 200 300 300 300 300 300 300 300 300 300 300 300 300
300 000 000 000 120 000 000 000 110 000 000 000 130 000 000 000 300
300 000 000 000 120 000 424 000 110 000 000 000 130 000 000 000 300
300 000 000 000 120 000 000 000 110 000 000 000 130 000 000 000 300
300 120 120 120 200 130 130 130 200 110 110 110 200 000 000 000 300
300 000 000 000 110 000 000 000 130 000 000 000 130 000 000 000 300
300 000 413 000 110 000 000 000 130 000 000 000 130 000 000 000 300
300 000 000 000 110 000 000 000 130 000 000 000 130 000 000 000 300
300 130 130 130 200 110 110 110 200 110 110 110 200 000 000 000 300
300 000 000 000 120 000 000 000 110 000 000 000 130 000 000 000 300
300 000 000 000 120 000 000 000 110 000 000 000 130 000 000 000 300
300 000 000 000 120 000 000 000 110 000 000 000 130 000 000 000 300
300 130 130 130 200 130 130 130 200 130 130 130 200 000 000 000 300
300 000 000 000 140 000 000 000 300 000 000 000 130 000 000 000 300
300 000 000 000 140 000 900 000 300 000 000 000 130 000 000 000 300
300 000 000 000 140 000 000 000 300 000 000 000 130 000 000 000 300
300 300 300 300 300 300 300 300 300 300 300 300 300 300 300 300 300
