200 120 120 120 200 120 120 120 130 120 120 120 120 120 120 120 120 120 120 120 120 120 120 120 120 120 120 120 120 120 120 120 
120 101 101 101 120 101 101 101 130 101 101 101 120 101 101 101 120 101 101 101 120 101 101 101 120 101 101 101 120 101 101 101 
120 101 500 101 120 101 101 101 130 101 333 101 120 101 101 101 120 101 101 101 120 101 101 101 120 101 101 101 120 101 101 101 
120 101 101 101 120 101 101 101 130 101 101 101 120 101 101 101 120 101 101 101 120 101 101 101 120 101 101 101 120 101 101 101 
120 120 120 120 120 120 120 120 130 120 120 120 120 120 120 120 120 120 120 120 120 120 120 120 120 120 120 120 120 120 120 120 
120 101 101 101 120 101 101 101 120 101 101 101 120 101 101 101 120 101 101 101 120 101 101 101 120 101 101 101 120 101 101 101 
120 101 500 101 120 101 101 101 120 101 101 101 120 101 101 101 120 101 500 101 120 101 101 101 120 101 101 101 120 101 101 101 
120 101 101 101 120 101 101 101 120 101 101 101 120 101 101 101 120 101 101 101 120 101 101 101 120 101 101 101 120 101 101 101 
120 120 120 120 120 120 120 120 130 120 120 120 120 120 120 120 120 120 120 120 120 120 120 120 120 120 120 120 120 120 120 120 
120 101 101 101 130 101 101 101 130 101 101 101 120 101 101 101 120 101 101 101 120 101 101 101 120 101 101 101 120 101 101 101 
120 101 420 101 130 101 410 101 130 101 101 101 120 101 101 101 120 101 101 101 120 101 101 101 120 101 101 101 120 101 101 101 
120 101 101 101 130 101 101 101 130 101 101 101 120 101 101 101 120 101 101 101 120 101 101 101 120 101 101 101 120 101 101 101 
130 130 130 130 130 130 130 130 130 130 130 130 130 130 130 130 130 130 130 130 130 130 130 130 130 130 130 130 130 130 130 130 
120 101 101 101 120 101 101 101 120 101 101 101 120 101 101 101 120 101 101 101 120 101 101 101 120 101 101 101 120 101 101 101 
120 101 430 101 120 101 101 101 120 101 101 101 120 101 101 101 120 101 101 101 120 101 101 101 120 101 101 101 120 101 101 101 
120 101 101 101 120 101 101 101 120 101 101 101 120 101 101 101 120 101 101 101 120 101 101 101 120 101 101 101 120 101 101 101 
120 120 120 120 120 120 120 120 120 120 120 120 120 120 120 120 120 120 120 120 120 120 120 120 120 120 120 120 120 120 120 120 
120 101 101 101 120 101 101 101 120 101 101 101 120 101 101 101 120 101 101 101 120 101 101 101 120 101 101 101 120 101 101 101 
120 101 440 101 120 101 101 101 120 101 101 101 120 101 101 101 120 101 101 101 120 101 101 101 120 101 101 101 120 101 101 101 
120 101 101 101 120 101 101 101 120 101 101 101 120 101 101 101 120 101 101 101 120 101 101 101 120 101 101 101 120 101 101 101 
120 120 120 120 120 120 120 120 120 120 120 120 120 120 120 120 120 120 120 120 120 120 120 120 120 120 120 120 120 120 120 120 
120 101 101 101 120 101 101 101 120 101 101 101 120 101 101 101 120 101 101 101 120 101 101 101 120 101 101 101 120 101 101 101 
120 101 101 101 120 101 101 101 120 101 101 101 120 101 101 101 120 101 101 101 120 101 101 101 120 101 101 101 120 101 101 101 
120 101 101 101 120 101 101 101 120 101 101 101 120 101 101 101 120 101 101 101 120 101 101 101 120 101 101 101 120 101 101 101 
120 120 120 120 120 120 120 120 120 120 120 120 120 120 120 120 120 120 120 120 120 120 120 120 120 120 120 120 120 120 120 120 
120 101 101 101 120 101 101 101 120 101 101 101 120 101 101 101 120 101 101 101 120 101 101 101 120 101 101 101 120 101 101 101 
120 101 101 101 120 101 101 101 120 101 101 101 120 101 101 101 120 101 101 101 120 101 101 101 120 101 101 101 120 101 101 101 
120 101 101 101 120 101 101 101 120 101 101 101 120 101 101 101 120 101 101 101 120 101 101 101 120 101 101 101 120 101 101 101 
120 120 120 120 120 120 120 120 120 120 120 120 120 120 120 120 120 120 120 120 120 120 120 120 120 120 120 120 120 120 120 120 
120 101 101 101 120 101 101 101 120 101 101 101 120 101 101 101 120 101 101 101 120 101 101 101 120 101 101 101 120 101 101 101 
120 101 101 101 120 101 101 101 120 101 101 101 120 101 101 101 120 101 101 101 120 101 101 101 120 101 101 101 120 101 101 101 
120 101 101 101 120 101 101 101 120 101 101 101 120 101 101 101 120 101 101 101 120 101 101 101 120 101 101 101 120 101 101 101 
