110 110 110 110 110 110 110 110 120 110 110 110 110 110 110 110 110 110 110 110 110 110 110 110 110 110 110 110 110 110 110 110 
110 101 101 101 110 101 101 101 120 101 101 101 110 101 101 101 110 101 101 101 110 101 101 101 110 101 101 101 110 101 101 101 
110 101 500 101 110 101 101 101 120 101 101 101 110 101 101 101 110 101 101 101 110 101 101 101 110 101 101 101 110 101 101 101 
110 101 101 101 110 101 101 101 120 101 101 101 110 101 101 101 110 101 101 101 110 101 101 101 110 101 101 101 110 101 101 101 
110 110 110 110 110 110 110 110 120 110 110 110 110 110 110 110 110 110 110 110 110 110 110 110 110 110 110 110 110 110 110 110 
110 101 101 101 110 101 101 101 110 101 101 101 110 101 101 101 110 101 101 101 110 101 101 101 110 101 101 101 110 101 101 101 
110 101 500 101 110 101 101 101 110 101 101 101 110 101 101 101 110 101 500 101 110 101 101 101 110 101 101 101 110 101 101 101 
110 101 101 101 110 101 101 101 110 101 101 101 110 101 101 101 110 101 101 101 110 101 101 101 110 101 101 101 110 101 101 101 
110 110 110 110 110 110 110 110 120 110 110 110 110 110 110 110 110 110 110 110 110 110 110 110 110 110 110 110 110 110 110 110 
110 101 101 101 120 101 101 101 120 101 101 101 110 101 101 101 110 101 101 101 110 101 101 101 110 101 101 101 110 101 101 101 
110 101 410 101 120 101 440 101 120 101 101 101 110 101 101 101 110 101 101 101 110 101 101 101 110 101 101 101 110 101 101 101 
110 101 101 101 120 101 101 101 120 101 101 101 110 101 101 101 110 101 101 101 110 101 101 101 110 101 101 101 110 101 101 101 
120 120 120 120 120 120 120 120 120 120 120 120 120 120 120 120 120 120 120 120 120 120 120 120 120 120 120 120 120 120 120 120 
110 101 101 101 110 101 101 101 110 101 101 101 110 101 101 101 110 101 101 101 110 101 101 101 110 101 101 101 110 101 101 101 
110 101 420 101 110 101 101 101 110 101 101 101 110 101 101 101 110 101 101 101 110 101 101 101 110 101 101 101 110 101 101 101 
110 101 101 101 110 101 101 101 110 101 101 101 110 101 101 101 110 101 101 101 110 101 101 101 110 101 101 101 110 101 101 101 
110 110 110 110 110 110 110 110 110 110 110 110 110 110 110 110 110 110 110 110 110 110 110 110 110 110 110 110 110 110 110 110 
110 101 101 101 110 101 101 101 110 101 101 101 110 101 101 101 110 101 101 101 110 101 101 101 110 101 101 101 110 101 101 101 
110 101 430 101 110 101 101 101 110 101 101 101 110 101 101 101 110 101 101 101 110 101 101 101 110 101 101 101 110 101 101 101 
110 101 101 101 110 101 101 101 110 101 101 101 110 101 101 101 110 101 101 101 110 101 101 101 110 101 101 101 110 101 101 101 
110 110 110 110 110 110 110 110 110 110 110 110 110 110 110 110 110 110 110 110 110 110 110 110 110 110 110 110 110 110 110 110 
110 101 101 101 110 101 101 101 110 101 101 101 110 101 101 101 110 101 101 101 110 101 101 101 110 101 101 101 110 101 101 101 
110 101 101 101 110 101 101 101 110 101 101 101 110 101 101 101 110 101 101 101 110 101 101 101 110 101 101 101 110 101 101 101 
110 101 101 101 110 101 101 101 110 101 101 101 110 101 101 101 110 101 101 101 110 101 101 101 110 101 101 101 110 101 101 101 
110 110 110 110 110 110 110 110 110 110 110 110 110 110 110 110 110 110 110 110 110 110 110 110 110 110 110 110 110 110 110 110 
110 101 101 101 110 101 101 101 110 101 101 101 110 101 101 101 110 101 101 101 110 101 101 101 110 101 101 101 110 101 101 101 
110 101 101 101 110 101 101 101 110 101 101 101 110 101 101 101 110 101 101 101 110 101 101 101 110 101 101 101 110 101 101 101 
110 101 101 101 110 101 101 101 110 101 101 101 110 101 101 101 110 101 101 101 110 101 101 101 110 101 101 101 110 101 101 101 
110 110 110 110 110 110 110 110 110 110 110 110 110 110 110 110 110 110 110 110 110 110 110 110 110 110 110 110 110 110 110 110 
110 101 101 101 110 101 101 101 110 101 101 101 110 101 101 101 110 101 101 101 110 101 101 101 110 101 101 101 110 101 101 101 
110 101 101 101 110 101 101 101 110 101 101 101 110 101 101 101 110 101 101 101 110 101 101 101 110 101 101 101 110 101 101 101 
110 101 101 101 110 101 101 101 110 101 101 101 110 101 101 101 110 101 101 101 110 101 101 101 110 101 101 101 110 101 101 101 
