200 140 140 140 200 140 140 140 110 140 140 140 140 140 140 140 140 140 140 140 140 140 140 140 140 140 140 140 140 140 140 140 
140 101 101 101 140 101 101 101 110 101 101 101 140 101 101 101 140 101 101 101 140 101 101 101 140 101 101 101 140 101 101 101 
140 101 500 101 140 101 101 101 110 101 101 101 140 101 101 101 140 101 101 101 140 101 101 101 140 101 101 101 140 101 101 101 
140 101 101 101 140 101 101 101 110 101 101 101 140 101 101 101 140 101 101 101 140 101 101 101 140 101 101 101 140 101 101 101 
140 140 140 140 140 140 140 140 110 140 140 140 140 140 140 140 140 140 140 140 140 140 140 140 140 140 140 140 140 140 140 140 
140 101 101 101 140 101 101 101 140 101 101 101 140 101 101 101 140 101 101 101 140 101 101 101 140 101 101 101 140 101 101 101 
140 101 500 101 140 101 101 101 140 101 101 101 140 101 101 101 140 101 500 101 140 101 101 101 140 101 101 101 140 101 101 101 
140 101 101 101 140 101 101 101 140 101 101 101 140 101 101 101 140 101 101 101 140 101 101 101 140 101 101 101 140 101 101 101 
140 140 140 140 140 140 140 140 110 140 140 140 140 140 140 140 140 140 140 140 140 140 140 140 140 140 140 140 140 140 140 140 
140 101 101 101 110 101 101 101 110 101 101 101 140 101 101 101 140 101 101 101 140 101 101 101 140 101 101 101 140 101 101 101 
140 101 440 101 110 101 430 101 110 101 101 101 140 101 101 101 140 101 101 101 140 101 101 101 140 101 101 101 140 101 101 101 
140 101 101 101 110 101 101 101 110 101 101 101 140 101 101 101 140 101 101 101 140 101 101 101 140 101 101 101 140 101 101 101 
110 110 110 110 110 110 110 110 110 110 110 110 110 110 110 110 110 110 110 110 110 110 110 110 110 110 110 110 110 110 110 110 
140 101 101 101 140 101 101 101 140 101 101 101 140 101 101 101 140 101 101 101 140 101 101 101 140 101 101 101 140 101 101 101 
140 101 410 101 140 101 101 101 140 101 101 101 140 101 101 101 140 101 101 101 140 101 101 101 140 101 101 101 140 101 101 101 
140 101 101 101 140 101 101 101 140 101 101 101 140 101 101 101 140 101 101 101 140 101 101 101 140 101 101 101 140 101 101 101 
140 140 140 140 140 140 140 140 140 140 140 140 140 140 140 140 140 140 140 140 140 140 140 140 140 140 140 140 140 140 140 140 
140 101 101 101 140 101 101 101 140 101 101 101 140 101 101 101 140 101 101 101 140 101 101 101 140 101 101 101 140 101 101 101 
140 101 420 101 140 101 101 101 140 101 101 101 140 101 101 101 140 101 101 101 140 101 101 101 140 101 101 101 140 101 101 101 
140 101 101 101 140 101 101 101 140 101 101 101 140 101 101 101 140 101 101 101 140 101 101 101 140 101 101 101 140 101 101 101 
140 140 140 140 140 140 140 140 140 140 140 140 140 140 140 140 140 140 140 140 140 140 140 140 140 140 140 140 140 140 140 140 
140 101 101 101 140 101 101 101 140 101 101 101 140 101 101 101 140 101 101 101 140 101 101 101 140 101 101 101 140 101 101 101 
140 101 101 101 140 101 101 101 140 101 101 101 140 101 101 101 140 101 101 101 140 101 101 101 140 101 101 101 140 101 101 101 
140 101 101 101 140 101 101 101 140 101 101 101 140 101 101 101 140 101 101 101 140 101 101 101 140 101 101 101 140 101 101 101 
140 140 140 140 140 140 140 140 140 140 140 140 140 140 140 140 140 140 140 140 140 140 140 140 140 140 140 140 140 140 140 140 
140 101 101 101 140 101 101 101 140 101 101 101 140 101 101 101 140 101 101 101 140 101 101 101 140 101 101 101 140 101 101 101 
140 101 101 101 140 101 101 101 140 101 101 101 140 101 101 101 140 101 101 101 140 101 101 101 140 101 101 101 140 101 101 101 
140 101 101 101 140 101 101 101 140 101 101 101 140 101 101 101 140 101 101 101 140 101 101 101 140 101 101 101 140 101 101 101 
140 140 140 140 140 140 140 140 140 140 140 140 140 140 140 140 140 140 140 140 140 140 140 140 140 140 140 140 140 140 140 140 
140 101 101 101 140 101 101 101 140 101 101 101 140 101 101 101 140 101 101 101 140 101 101 101 140 101 101 101 140 101 101 101 
140 101 101 101 140 101 101 101 140 101 101 101 140 101 101 101 140 101 101 101 140 101 101 101 140 101 101 101 140 101 101 101 
140 101 101 101 140 101 101 101 140 101 101 101 140 101 101 101 140 101 101 101 140 101 101 101 140 101 101 101 140 101 101 101 
