200 130 130 130 200 130 130 130 140 130 130 130 130 130 130 130 130 130 130 130 130 130 130 130 130 130 130 130 130 130 130 130 
130 101 101 101 130 101 101 101 140 101 101 101 130 101 101 101 130 101 101 101 130 101 101 101 130 101 101 101 130 101 101 101 
130 101 500 101 130 101 101 101 140 101 101 101 130 101 101 101 130 101 101 101 130 101 101 101 130 101 101 101 130 101 101 101 
130 101 101 101 130 101 101 101 140 101 101 101 130 101 101 101 130 101 101 101 130 101 101 101 130 101 101 101 130 101 101 101 
130 130 130 130 130 130 130 130 140 130 130 130 130 130 130 130 130 130 130 130 130 130 130 130 130 130 130 130 130 130 130 130 
130 101 101 101 130 101 101 101 130 101 101 101 130 101 101 101 130 101 101 101 130 101 101 101 130 101 101 101 130 101 101 101 
130 101 500 101 130 101 101 101 130 101 101 101 130 101 101 101 130 101 500 101 130 101 101 101 130 101 101 101 130 101 101 101 
130 101 101 101 130 101 101 101 130 101 101 101 130 101 101 101 130 101 101 101 130 101 101 101 130 101 101 101 130 101 101 101 
130 130 130 130 130 130 130 130 140 130 130 130 130 130 130 130 130 130 130 130 130 130 130 130 130 130 130 130 130 130 130 130 
130 101 101 101 140 101 101 101 140 101 101 101 130 101 101 101 130 101 101 101 130 101 101 101 130 101 101 101 130 101 101 101 
130 101 430 101 140 101 420 101 140 101 101 101 130 101 101 101 130 101 101 101 130 101 101 101 130 101 101 101 130 101 101 101 
130 101 101 101 140 101 101 101 140 101 101 101 130 101 101 101 130 101 101 101 130 101 101 101 130 101 101 101 130 101 101 101 
140 140 140 140 140 140 140 140 140 140 140 140 140 140 140 140 140 140 140 140 140 140 140 140 140 140 140 140 140 140 140 140 
130 101 101 101 130 101 101 101 130 101 101 101 130 101 101 101 130 101 101 101 130 101 101 101 130 101 101 101 130 101 101 101 
130 101 440 101 130 101 101 101 130 101 101 101 130 101 101 101 130 101 101 101 130 101 101 101 130 101 101 101 130 101 101 101 
130 101 101 101 130 101 101 101 130 101 101 101 130 101 101 101 130 101 101 101 130 101 101 101 130 101 101 101 130 101 101 101 
130 130 130 130 130 130 130 130 130 130 130 130 130 130 130 130 130 130 130 130 130 130 130 130 130 130 130 130 130 130 130 130 
130 101 101 101 130 101 101 101 130 101 101 101 130 101 101 101 130 101 101 101 130 101 101 101 130 101 101 101 130 101 101 101 
130 101 410 101 130 101 101 101 130 101 101 101 130 101 101 101 130 101 101 101 130 101 101 101 130 101 101 101 130 101 101 101 
130 101 101 101 130 101 101 101 130 101 101 101 130 101 101 101 130 101 101 101 130 101 101 101 130 101 101 101 130 101 101 101 
130 130 130 130 130 130 130 130 130 130 130 130 130 130 130 130 130 130 130 130 130 130 130 130 130 130 130 130 130 130 130 130 
130 101 101 101 130 101 101 101 130 101 101 101 130 101 101 101 130 101 101 101 130 101 101 101 130 101 101 101 130 101 101 101 
130 101 101 101 130 101 101 101 130 101 101 101 130 101 101 101 130 101 101 101 130 101 101 101 130 101 101 101 130 101 101 101 
130 101 101 101 130 101 101 101 130 101 101 101 130 101 101 101 130 101 101 101 130 101 101 101 130 101 101 101 130 101 101 101 
130 130 130 130 130 130 130 130 130 130 130 130 130 130 130 130 130 130 130 130 130 130 130 130 130 130 130 130 130 130 130 130 
130 101 101 101 130 101 101 101 130 101 101 101 130 101 101 101 130 101 101 101 130 101 101 101 130 101 101 101 130 101 101 101 
130 101 101 101 130 101 101 101 130 101 101 101 130 101 101 101 130 101 101 101 130 101 101 101 130 101 101 101 130 101 101 101 
130 101 101 101 130 101 101 101 130 101 101 101 130 101 101 101 130 101 101 101 130 101 101 101 130 101 101 101 130 101 101 101 
130 130 130 130 130 130 130 130 130 130 130 130 130 130 130 130 130 130 130 130 130 130 130 130 130 130 130 130 130 130 130 130 
130 101 101 101 130 101 101 101 130 101 101 101 130 101 101 101 130 101 101 101 130 101 101 101 130 101 101 101 130 101 101 101 
130 101 101 101 130 101 101 101 130 101 101 101 130 101 101 101 130 101 101 101 130 101 101 101 130 101 101 101 130 101 101 101 
130 101 101 101 130 101 101 101 130 101 101 101 130 101 101 101 130 101 101 101 130 101 101 101 130 101 101 101 130 101 101 101 
